16
16
################
#_#____________#
#_###__####____#
#_________#____#
#_________#____#
######____#__###
#_________#____#
#____###__#____#
#_________##___#
#__$______#____#
#__%______#____#
#__#$$$___%____#
#__#______$____#
#______________#
#______________#
################